11111111111111111111111111111111111111111111111111111111111111111111111
10100000100000000000000000000000000000000000000000000000000000000000001
10101010101111111000000000000000000000000000000000000000000000000000001
10001010001000001000000000000000000000000000000000000000000000000000001
11111010111110101110000000000000000000000000000000000000000000000000001
10000010100010100000000000000000000000000000000000000000000000000000001
10111110101110111111000000000000000000000000000000000000000000000000001
10100000101010000010000000000000000000000000000000000000000000000000001
10101111101011111010000000000000000000000000000000000000000000000000001
10101000101010001010000000000000000000000000000000000000000000000000001
10111010101010101010000000000000000000000000000000000000000000000000001
10000010101000101000000000000000000000000000000000000000000000000000001
11111110101111101110000000000000000000000000000000000000000000000000001
100000101000100010C0000000000000000000000000000000000000000000000000001
10111010111010111011000000000000000000000000000000000000000000000000001
10100010000010001010000000000000000000000000000000000000000000000000001
101011111111111010C0000000000000000000000000000000000000000000000000001
100010000000000010C0000000000000000000000000000000000000000000000000001
10101011101111111110000000000000000000000000000000000000000000000000001
10100000100000000000000000000000000000000000000000000000000000000000001
11111111111111111111111111111111111111111111111111111111111111111111111